hey	Hi!
hello	Nama kebuah nuan ngiga aku?
hi	Hello!
hai hai	Hello wai!
selamat pagi	Nuan bisi utai ka ditusi?
selamat lemai	Yoohoo!
oi	Oh hi!
hi nuan	Hye!
hi, aram berandau	Nama randau tua?
hai uchak	Hai!
hello bot	Heyoo!
hello nuan	Ui!
selamat siang	Hmm , nama utai ka dikejakuka nuan?
hi	Eh! Nuan pia!
helloo	Nama nyadika buah randau tua?
siang	Randau nama patut dikejaku tua?
hi bot!	Hai! Aram berandau!
yohoo!	Oh, hai kaban!
hello bot	Nama utai ba runding nuan?
hi chatbot	Helo!
hi kaban	Nadai utai dirunding nuan dia?
wei nuan	Eheii!
ui	Nama ga nuan ngiga aku wai?
yo	Nama ga nuan ngiga aku kaban?
nama pengawa nuan?	Weii!
ulih nuan nerangka pasal sistem sepil jaku iban?	antara bengkah ti bisi dalam sistem sepil jaku iban iya nya urat jaku.
ulih nuan madahka pasal sepil jaku iban?	jaku iban nguna dua puluh enam urup roman.
ulih nuan madahka aku pasal sistem sepil jaku iban?	sepil jaku iban bisi tebagi ngagai sekeda bengkah atur.
ulih nuan madah ni bagi atur sepil jaku iban?	antara atur sepil jaku iban iya atur nulis urat jaku, atur nulis penambah, homograf enggau homonim.
ajar aku pasal sistem sepil jaku iban.	bahasa iban ngena dua puluh enam urup roman baka bahasa melayu.
padahka pasal sistem sepil jaku iban.	homograf nya antara sistem sepil jaku iban.
baka ni sistem sepil jaku iban?	siti ari sistem sepil jaku iban iya nya homonim.
nama jaku iban bisi sebaka enggau bahasa melayu?	bisi, bahasa iban ngena dua puluh enam urup roman baka bahasa melayu.
kati bahasa melayu sebaka enggau bahasa iban?	bahasa melayu enggau bahasa iban bela nguna dua puluh enam urup roman.	
nama bengkah sistem sepil ti bisi dalam jaku iban?	antara bengkah sistem sepil jaku iban iya nya atur nulis urat jaku, penambah, homograf enggau homonim.
padahka bengkah sistem sepil jaku iban.	bengkah sistem sepil jaku iban iya nya atur nulis urat jaku, homograf, homonim enggau atur nulis penambah.
sistem sepil jaku iban bisi tebagi ngagai bengkah nama?	sistem sepil jaku iban bisi nyengkaum homograf, atur nulis urat jaku, homonim enggau atur nulis penambah.
nama bagi sistem sepil bisi dalam jaku iban?	sistem sepil ti udah ditemu aku iya nya raban jaku nama, jaku pengawa enggau jaku adjektif.
sistem sepil jaku iban bisi berapa bengkah?	antara sistem sepil ke bukai iya nya raban jaku nama enggau jaku adjektif.
nama sistem sepil jaku iban ke bukai?	sistem sepil ke bukai ti bisi iya nya jaku adjektif, jaku pengawa enggau jaku nama.
baka ni gaya sistem sepil jaku ke bukai?	jaku adjektif, jaku pengawa enggau jaku nama.
nama bengkah jaku iban?	sistem sepil ke bukai ti ditemu aku iya nya jaku pengawa, jaku adjektif enggau jaku nama.
aku ka nnya, kati bisi sistem sepil ke bukai?	sistem sepil ti ditemu aku nyengkaum jaku adjektif, jaku pengawa enggau jaku nama.
kelimpah ari nya?	bengkah atur ti bisi dalam sepil jaku iban iya nya atur nulis urat jaku, atur nulis penambah, homograf enggau homonim.
kati bisi sistem sepil ke bukai?	atur nulis urat jaku, atur nulis penambah, homograf enggau homonim.
ulih nuan madahka pasal atur nulis urat jaku lebih dalam agi ?	urat jaku nya seleka jaku ditulis serara ari jaku bukai lalu nadai diberi penambah.
baka ni atur ngena urat jaku?	semua urat jaku patut ditulis serara lebuh ditulis dalam ayat.
baka ni chara ngena atur urat jaku?	urat jaku ditulis bediri kediri ari jaku bukai ba ayat.
ajar aku pasal atur nulis urat jaku.	atur urat jaku patut ditulis serara ari jaku bukai lebuh dikena ba dalam rambai jaku.
nama atur ngena urat jaku ti bendar?	urat jaku tu ditulis kediri, enda begulai enggau jaku bukai.
nama chunto urat jaku?	chunto urat jaku iya nya -surat kabar lama-.
bisi chunto bagi urat jaku?	-surat kabar lama-
nama chunto urat bagi jaku?	antara chunto urat jaku iya nya - surat kabar lama.-
beri siti chunto urat jaku.	-rumah batu tiga tingkat-
chunto bagi urat jaku?	chunto urat jaku iya nya -rumah batu tiga tingkat-.
nama chunto bukai urat jaku?	chunto bukai urat jaku iya nya -selipar putus tali-.
bisi chunto bukai bagi urat jaku?	chunto ti bukai iya nya -pansuh tiga ruas-.
nama chunto bukai urat bagi jaku?	-selipar putus tali-.
beri siti chunto bukai urat jaku.	-pansuh tiga ruas-.
chunto bukai bagi urat jaku?	-kerita pancit tayar- nya chunto urat jaku ti bukai.
baka ni jalai nulis urat jaku ba ayat?	chunto urat jaku ba ayat iya nya -igat bisi dua pasang kasut baru-.
nama chunto rambai jaku ti ngena urat jaku?	-indai meli dua buah lemari baru.-
chunto ayat ti ngena urat jaku?	chunto ayat ti ngena urat jaku iya nya - Indai bisi meli dua buah lemari baru-.
beri chunto ayat ngena urat jaku.	-ali ngena selipar putus tali-.
chunto ayat?	chunto rambai jaku iya nya - ali ngena selipar putus tali-.
bisi chunto ayat ngena urat jaku ke bukai?	chunto ayat ngena urat jaku ke bukai iya nya -Ali tinggi agi ari Abu-.
bisi chunto urat jaku ke bukai?	-Ali tinggi agi ari Abu-
ulih nuan meri aku chunto kedua rambai jaku ti nguna atur urat jaku?	chunto bukai ayat ti ngena urat jaku iya nya - lemari dua tingkat nya dibeli apai kemari-.
chunto urat jaku ti bukai?	-lemari dua tingkat nya dibeli apai kemari-.
padah chunto urat jaku ke bukai?	chunto rambai jaku ti bukai iya nya -sintin rindu bendar begaya ngena buk tanchang dua-.
ulih nuan madahka aku pasal atur nulis penambah?	semua penambah ditulis besambung enggau leka jaku ti ditambah iya.
ulih nuan nerangka pasal atur ngena nulis jaku penambah lebih dalam agi?	tanda sekang enda tau dikena antara jaku penambah enggau urat jaku.
nama agi patut ditemu aku pasal jaku penambah?	enti nuan ka nemu, jaku iban tulin bisi siti aja penambah ujung leka jaku iya nya penambah -ka.
ajar aku pasal atur nulis penambah.	nyadi penambah tu ditulis sekali enggau leka jaku ti nguna penambah nya.
terangka pasal atur nulis penambah.	bisi, antara bengkah jaku penambah iya nya penambah jaku betandu sebut enggau penambah ujung leka jaku
nama bengkah jaku penambah ti bisi?	antara chunto jaku penambah iya nya -be- ti dikena ba belagu.
bengkah bagi jaku penambah?	be ti dikena ba urat jaku besai nya chunto penambah jaku betandu sebut.
padahka bagi jaku penambah ti bisi.	enti nuan enda nemu, jaku iban tulin bisi siti aja penambah ujung leka jaku iya nya penambah 'ka'.
beri bengkah ti bisi dalam jaku penambah.	chunto jaku ngena penambah ujung jaku 'ka' iya nya belalaika.
terangka pasal penambah pun jaku.	penambah b- dikena ba dalam pun jaku.
nama penambah ti dikena dalam penambah pun jaku?	be- nya antara penambah pun jaku.
beri penambah ti dikena dalam penambah pun jaku?	antara penambah pun jaku iya nya di-, em- enggau en-
baka ni gaya penambah pun jaku?	ke- enggau m- nya antara penambah pun jaku
penambah pun jaku nya baka ni?	n- dikena dalam penambah pun jaku.
nama chunto jaku penambah pun jaku?	chunto jaku ti ngena penambah pun jaku -b iya nya -bumai.
bisi chunto bagi jaku penambah pun jaku?	chunto jaku ngena penambah pun jaku iya nya -belajar.
nama chunto ti bisi bagi jaku penambah pun jaku?	-belajar, -belatur, -belinsur
beri siti chunto jaku penambah pun jaku.	antara chunto jaku ti ngena penambah pun jaku iya nya belajar.
chunto bagi jaku penambah pun jaku?	-belatur nya antara chunto jaku ti ngena penambah pun jaku -be.
nama chunto bukai jaku penambah pun jaku?	chunto jaku bukai ti ngena penambah pun jaku -b iya nya -bulih.
bisi chunto bukai bagi jaku penambah pun jaku?	chunto bukai jaku ngena penambah pun jaku iya nya -berakit.
nama chunto ti bukai bagi jaku penambah pun jaku?	-berakit, -belagu, -bepantun
beri siti chunto bukai jaku penambah pun jaku.	antara chunto jaku bukai ti ngena penambah pun jaku iya nya bepantun.
chunto bukai bagi jaku penambah pun jaku?	-belagu nya antara chunto jaku bukai ti ngena penambah pun jaku -be.
baka ni jalai nulis jaku penambah pun jaku ba ayat?	chunto rambai jaku iya nya -iya bumai ba emperan bukit nyin.-
nama chunto rambai jaku ti ngena jaku penambah pun jaku?	-sida beduruk pangan diri lebuh bumai-.
chunto ayat ti ngena jaku penambah pun jaku?	chunto ayat iya nya -indai ngasuh ika belajar bebendar-.
beri chunto ayat ngena jaku penambah pun jaku.	ayat bagi penambah pun jaku iya nya -chara kesatu nya salah-.
chunto ayat?	-indai meli sayur ba pasar-.
bisi chunto ayat ngena jaku penambah pun jaku ke bukai?	chunto bukai iya nya -iya bulih mayuh ikan maya nyala tadi-.
bisi chunto jaku penambah pun jaku ke bukai?	chunto ti bukai iya nya -bala nembiak nya berakit ke seberai sungai-.
ulih nuan meri aku chunto kedua rambai jaku ti nguna atur jaku penambah pun jaku?	ayat ti bukai iya nya -iya rindu bendar belagu-.
chunto jaku penambah pun jaku ti bukai?	-niang aki aku suba landik bepantun-.
padah chunto jaku penambah pun jaku ke bukai?	rambai jaku ti bukai iya nya -iya malu duduk berimbai enggau aku-.
terangka pasal penambah ujung jaku.	penambah -ka dikena ba dalam ujung jaku.
nama penambah ti dikena dalam penambah ujung jaku?	b..ka nya antara penambah ujung jaku.
beri penambah ti dikena dalam penambah ujung jaku?	antara penambah ujung jaku iya nya bel..ka, ber..ka enggau bes..ka
baka ni gaya penambah ujung jaku?	en..ka enggau em..ka nya antara penambah ujung jaku
penambah ujung jaku nya baka ni?	ng..ka dikena dalam penambah ujung jaku.
nama chunto jaku penambah ujung jaku?	chunto jaku ti ngena penambah ujung jaku -ka iya nya -gariska.
bisi chunto bagi jaku penambah ujung jaku?	chunto jaku ngena penambah ujung jaku iya nya -baumka.
nama chunto ti bisi bagi jaku penambah ujung jaku?	-gariska, -baumka, -belajarka
beri siti chunto jaku penambah ujung jaku.	antara chunto jaku ti ngena penambah ujung jaku iya nya belajarka.
chunto bagi jaku penambah ujung jaku?	-berantika nya antara chunto jaku ti ngena penambah ujung jaku -ber..ka
nama chunto bukai jaku penambah ujung jaku?	chunto jaku bukai ti ngena penambah ujung jaku -ka iya nya -tinggalka.
bisi chunto bukai bagi jaku penambah ujung jaku?	chunto bukai jaku ngena penambah ujung jaku iya nya -nyabakka.
nama chunto ti bukai bagi jaku penambah ujung jaku?	-tinggalka, -nyabakka, -beratika.
beri siti chunto bukai jaku penambah ujung jaku.	antara chunto jaku bukai ti ngena penambah ujung jaku iya nya beratika.
chunto bukai bagi jaku penambah ujung jaku?	-berandauka nya antara chunto jaku bukai ti ngena penambah ujung jaku -be..ka.
baka ni jalai nulis jaku penambah ujung jaku ba ayat?	chunto rambai jaku iya nya -gariska saut ti betul.-
nama chunto rambai jaku ti ngena jaku penambah ujung jaku?	-sida belaya lebuh baumka bala sida ti deka nguai-.
chunto ayat ti ngena jaku penambah ujung jaku?	chunto ayat iya nya -iya pedih pala belajarka sains komputer-.
beri chunto ayat ngena jaku penambah ujung jaku.	ayat bagi penambah ujung jaku iya nya -iya sinu kediri beratika orang gila nya-.
chunto ayat?	-aku lelak berantika barang pos laju datai-.
bisi chunto ayat ngena jaku penambah ujung jaku ke bukai?	chunto bukai iya nya -tinggalka barang ti enda diguna ngambi perau enda sarat-.
bisi chunto jaku penambah ujung jaku ke bukai?	chunto ti bukai iya nya -mata iya kembai nyabakka buku iya lenyau-.
ulih nuan meri aku chunto kedua rambai jaku ti nguna atur jaku penambah ujung jaku?	ayat ti bukai iya nya -aku beratika nuan ari tadi-.
chunto jaku penambah ujung jaku ti bukai?	-sida iya berandauka kebun sawit-.
padah chunto jaku penambah ujung jaku ke bukai?	rambai jaku ti bukai iya nya -iya enda meretika utai ti dipadahka nuan-.
terangka pasal penambah betandu sebut.	penambah -be dikena ba dalam betandu sebut.
nama penambah ti dikena dalam penambah betandu sebut?	che- nya antara penambah betandu sebut.
beri penambah ti dikena dalam penambah betandu sebut?	antara penambah betandu sebut iya nya be- enggau che-
baka ni gaya penambah betandu sebut?	de- enggau ge- nya antara penambah betandu sebut
penambah betandu sebut nya baka ni?	je- dikena dalam penambah betandu sebut.
nama chunto jaku penambah betandu sebut?	chunto jaku ti ngena penambah betandu sebut -be iya nya -bebendar.
bisi chunto bagi jaku penambah betandu sebut?	chunto jaku ngena penambah betandu sebut iya nya -bebesai.
nama chunto ti bisi bagi jaku penambah betandu sebut?	-bebendar, -bebesai, -bebaru
beri siti chunto jaku penambah betandu sebut.	antara chunto jaku ti ngena penambah betandu sebut iya nya chechamang.
chunto bagi jaku penambah betandu sebut?	-dedigak nya antara chunto jaku ti ngena penambah betandu sebut -de
nama chunto bukai jaku penambah betandu sebut?	chunto jaku bukai ti ngena penambah betandu sebut -be iya nya -bebichai.
bisi chunto bukai bagi jaku penambah betandu sebut?	chunto bukai jaku ngena penambah betandu sebut iya nya -lelese.
nama chunto ti bukai bagi jaku penambah betandu sebut?	-bebichai, -lelese, -lelingai.
beri siti chunto bukai jaku penambah betandu sebut.	antara chunto jaku bukai ti ngena penambah betandu sebut iya nya nenegu.
chunto bukai bagi jaku penambah betandu sebut?	-pepeli nya antara chunto jaku bukai ti ngena penambah betandu sebut -pe
baka ni jalai nulis jaku penambah betandu sebut ba ayat?	chunto rambai jaku iya nya -iya nyabak bebendar laban tusah ati.-
nama chunto rambai jaku ti ngena jaku penambah betandu sebut?	-ikan ulih aki nyala tadi bebesai-.
chunto ayat ti ngena jaku penambah betandu sebut?	chunto ayat iya nya -gari ti ba dalam lemari nya bebaru-.
beri chunto ayat ngena jaku penambah betandu sebut.	ayat bagi penambah betandu sebut iya nya -iya enda chechamang nikauka ular nya-.
chunto ayat ti ngena jaku penambah betandu sebut?	-duku nya dedigak ba pun kayu nya-.
bisi chunto ayat ngena jaku penambah betandu sebut ke bukai?	chunto bukai iya nya -darah jari iya bebichai laban enda dibalut-.
bisi chunto jaku penambah betandu sebut ke bukai?	chunto ti bukai iya nya -bale dianu indai laban iya lelese lebuh ditanya-.
ulih nuan meri aku chunto kedua rambai jaku ti nguna atur jaku penambah betandu sebut?	ayat ti bukai iya nya -aku lelingai lebuh bejalai tadi laban lapar-.
chunto jaku penambah betandu sebut ti bukai?	-anang nenegu mangkuk nya.-.
padah chunto jaku penambah betandu sebut ke bukai?	rambai jaku ti bukai iya nya -mata iya pepeli meda gajah.-.
nuan nemu reti jaku 'lebas'?	reti 'lebas' iya nya leka jaku ti udah tegap dikena baka siku, siti enggau sigi.
padahka reti jaku -lebas'.	lebas nya jaku ti udah tegap baka leka jaku -siti, -siku enggau -sigi
aku ka nemu pasal homonim.	nemu, homonim nya leka jaku ti sebaka sepil sereta sebaka sebut tang enda sebaka reti.
baka ni ngna atur homonim?	homonim nya ngembuan leka jaku ti sebaka sebut tang lain reti.
kati baka atur ngena homonim deh?	oh, homonim enda sebaka enggau homograf laban iya leka jaku ngembuan chara sebut ti sebaka.
terangka pasal homonim.	leka jaku ti sebaka sepil enggau sebut tang ngembuan lain reti.
kati baka atur ngena homonim?	siti jaku ti ngembuan lain reti taja sebaka sepil enggau chara sebut.
ajar pasal homonim.	jaku homonim ngembuan reti ti lain taja sebaka chara sebut enggau sepil.
padahka pasal homonim.	homonim nya jaku ti ngembuan sebaka sepil enggau chara sebut tang lain reti.
nama chunto bagi homonim?	leka jaku homonim ti ditemu aku iya nya 'kala'.
padahka chunto bagi homonim.	bisi dua iti chunto rambai jaku ti nguna homonim 'kala'.
chunto homonim?	antara chunto leka jaku homonim iya nya 'kala'
chunto bagi homonim?	leka jaku homonim ti ditemu aku iya nya 'buruk'.
beri chunto homonim.	bisi dua iti chunto rambai jaku ti nguna homonim 'buruk'.
meri aku chunto homonim.	antara chunto leka jaku homonim iya nya 'buruk'
nama chunto homonim?	leka jaku homonim ti ditemu aku iya nya 'mulung'.
meri aku siti chunto homonim.	bisi dua iti chunto rambai jaku ti nguna homonim 'mulung'.
beri siti chunto bagi homonim.	antara chunto leka jaku homonim iya nya 'mulung'
padahka siti chunto bagi homonim.	antara leka jaku homonim iya nya -kala, -mulung enggau buruk.
nama reti keterubah mulung?	utai ti tumbuh.
nama reti kesatu mulung?	reti mulung keterubah iya nya siti utai tumbuh.
nama chunto ayat ti ngena reti kesatu mulung?	-umang mulung buah mawang ba belakang rumah.
chunto ayat ti ngena reti keterubah mulung?	-aki mulung buah rian ba kebun.
nama reti kedua mulung?	reti kedua iya nya ngumpul buah.
nama reti bukai mulung?	reti mulung ti kedua iya nya pengawa ngumpul buah.
nama chunto ayat ti ngena reti kedua mulung?	-aki nebang pun mulung nya lemai legi.
chunto ayat ti ngena reti mulung ti kedua	-aki nebang pun mulung nya lemai legi.
nama reti keterubah buruk?	reti kesatu buruk iya nya ngelusu.
nama reti kesatu buruk?	reti keterubah buruk iya nya ulah ti ngelusu.
nama chunto ayat ti ngena reti kesatu buruk?	-impek dianu indai iya laban buruk ngereja pengawa rumah.
chunto ayat ti ngena reti keterubah buruk?	-orang ti buruk ngereja pengawa sigi enda mujur.
nama reti kedua buruk?	reti kedua buruk iya nya utai ti udah jai.
nama reti bukai buruk?	reti buruk ti kedua iya nya utai ti udah jai.
nama chunto ayat ti ngena reti kedua buruk?	-pun lada nya tumbang laban udah buruk.
chunto ayat ti ngena reti buruk ti kedua?	-tiang rumah nya buruk diempa merung.
nama reti keterubah kala?	reti kesatu kala iya nya besangkut paut enggau maya tauka lebuh.
nama reti kesatu kala?	reti keterubah kala iya nya madahka maya tauka lebuh.
nama chunto ayat ti ngena reti kesatu kala?	rambai jaku ti keterubah nya nya ambai kala nemuai ngagai rumah aku.
chunto ayat ti ngena reti keterubah kala?	rambai jaku ti keterubah nya nya ambai kala nemuai ngagai rumah aku.
nama reti kedua kala?	rambai jaku ti keterubah nya nya ambai kala nemuai ngagai rumah aku.
nama reti kala ke bukai?	reti bukai kala iya sebansa unggas ti nyenggat.
nama chunto ayat ti ngena reti kedua kala?	-kami sebilik begau laban meda kala ba ruang bilik.
chunto ayat ti ngena reti kala ti kedua?	-kala nya bejalai tisi pasu bungai.
nama utai homograf nya?	homograf nya baka sinonim ba Bahasa Melayu.
nama reti homograf?	homograf nya ka sebaka enggau sinonim ti dikena dalam Bahasa Melayu.
homograf?	homograf nya leka jaku ti sebaka sepil sereta sebaka sebut tang enda sebaka reti.
padahka pasal homograf.	homograf nya leka jaku ti bisi sebaka sepil, lain chara nyebut lalu enda sebaka reti.
terangka homograf.	au, homograf nya ka sebaka enggau sinonim ti dikena dalam Bahasa Melayu.
baka ni gaya homograf nya?	homograf nya lain ari homonim.
ajar pasal homograf.	homograf nya jaku ti ngembuan sebaka sepil tang enda sebaka sebut.
homograf nya nama?	jaku ti ngembuan sebaka sepil tang enda sebaka chara sebut nya homograf.
nama chunto bagi homograf?	nyadi chunto bagi leka jaku homograf iya nya -asi.
padahka chunto pasal homograf.	siti chunto homograf iya nya leka jaku -asi.
beri aku siti chunto bagi homograf.	leka jaku -asi nya antara chunto homograf.
baka ni chunto homograf.	chunto homograf iya nya -asi.
chunto homograf?	-peti nya leka jaku homograf.
homograf nya baka ni chunto iya?	chunto leka jaku bagi homograf iya nya -peti.
meri aku siti chunto homograf.	siti chunto leka jaku homograf iya nya -peti.
siti chunto bagi homograf?	-asi enggau -peti.
bisi chunto homograf ti bukai?	nyadi chunto bukai bagi leka jaku homograf iya nya -emparu.
chunto bukai bagi homograf?	siti chunto bukai homograf iya nya leka jaku -emparu.
padahka aku chunto homograf ti bukai.	leka jaku -emparu nya antara chunto bukai homograf.
beri chunto homograf ti bukai.	chunto bukai homograf iya nya -emparu.
baka ni chunto homograf ti bukai?	-mata nya leka jaku homograf.
chunto leka jaku homograf ti bukai?	chunto bukai leka jaku bagi homograf iya nya -mata.
nama chunto bukai bagi homograf?	siti chunto bukai leka jaku homograf iya nya -mata.
chunto jaku bukai homograf?	-asi enggau -mata.
nama reti -asi ti keterubah?	reti keterubah -asi iya nya beras ti udah ditanak.
ulih nuan madah nama reti -asi ti kesatu?	reti kesatu -asi nya bekaul enggau utai diempa.
nama reti kedua -asi?	reti kedua -asi nya madahka orang ti diandai.
reti kedua -asi?	reti bukai -asi iya nya orang ti disayau.
chunto ayat bagi reti -asi kesatu?	chunto ayat ti ngena reti kesatu asi iya nya -asi nya udah bari.-
nama chunto ayat bagi -asi ti ngena reti kesatu?	-iya lapar laban nadai ngemai asi ke bekal.-
beri chunto ayat ngena reti -asi ti keterubah.	-indai ngasuh igat nanak asi.-
padahka chunto ayat ti ngena reti -asi kesatu.	rambai jaku ti ngena reti keterubah asi iya nya -asi nya udah mansau.-
chunto ayat bagi reti -asi kedua?	-kumang anak asi apai indai iya.-
nama chunto ayat bagi -asi ti ngena reti kedua?	chunto ayat iya nya -jambi nya uchu asi aki ini iya-
beri chunto ayat ngena reti -asi ti bukai.	-aku anak asi apai enggau indai aku.-
padahka chunto ayat ti ngena reti -asi kedua.	-iya nyabak laban anak asi iya sekula jauh-
nama reti -mata ti keterubah?	reti kesatu mata iya nya bekaul enggau perengka tubuh ti dikena meda.
ulih nuan madah nama reti mata ti kesatu?	perengka tubuh ti dikena meda nya reti kesatu mata.
nama reti kedua -mata?	reti kedua mata iya nya utai ti dipanduk enda mansau.
reti kedua -mata?	utai ti enda mansau nya reti kedua mata.
chunto ayat bagi reti -mata kesatu?	-mata iya makin hari makin rabun-
nama chunto ayat bagi -mata ti ngena reti kesatu?	-mata iya nyu kembai dibai nyabak sehari-hari-
beri chunto ayat ngena reti -mata ti keterubah.	-mata iya melut lebuh tekenyit meda ular-
padahka chunto ayat ti ngena reti -mata kesatu.	-iya ngusuk mata iya laban gatal-
chunto ayat bagi reti -mata kedua?	-buah rian nya agi mata-
nama chunto ayat bagi -mata ti ngena reti kedua?	-manuk guring ti dibeli igat nya mata.-
beri chunto ayat ngena reti -mata ti bukai.	-buah rampu tau diempa mata-
padahka chunto ayat ti ngena reti -mata kedua.	-ikan kukus nya mata-
nama reti -peti ti keterubah?	reti kesatu peti iya nya alai endur nyimpan perengka.
ulih nuan madah nama reti peti ti kesatu?	reti keterubah peti iya nya endur besimpanka barang.
nama reti kedua -peti?	reti kedua peti iya nya panjuk dikena nangkap jelu.
reti kedua -peti?	reti bukai peti iya nya panjuk ti dikena ngulihka jelu babas.
chunto ayat bagi reti -peti kesatu?	-jarum nya disimpan di dalam peti-
nama chunto ayat bagi -peti ti ngena reti kesatu?	-ini ngiga tinchin iya ti disimpan di dalam peti-
beri chunto ayat ngena reti -peti ti keterubah.	-peti nya tau endur nyimpan perengka emas.-
padahka chunto ayat ti ngena reti -peti kesatu.	-peti nya enda ulih dibuka laban bekunchi-
chunto ayat bagi reti -peti kedua?	-jani nya diulih ngena peti-
nama chunto ayat bagi -peti ti ngena reti kedua?	-kaki aki telih laban tekena peti-
beri chunto ayat ngena reti -peti ti bukai.	-igat landik ngaga peti-
padahka chunto ayat ti ngena reti -peti kedua.	-peti nya dilalaika semak babas ngambi jelu enda meda.
nama reti -emparu ti keterubah?	reti kesatu emparu iya nya mela jelu.
ulih nuan madah nama reti emparu ti kesatu?	pengawa mela jelu nya reti keterubah emparu.
nama reti kedua -emparu?	reti kedua emparu iya nya sebansa ular.
reti kedua -emparu?	sebansa ular nya reti kedua emparu.
chunto ayat bagi reti -emparu kesatu?	-kami emparu jani nya ari mit.-
nama chunto ayat bagi -emparu ti ngena reti kesatu?	-manuk emparu ini lenyau dichuri orang.-
beri chunto ayat ngena reti -emparu ti keterubah.	-niang aki rindu emparu kambing-
padahka chunto ayat ti ngena reti -emparu kesatu.	-aki landik bendar dalam pengawa emparu jani.-
chunto ayat bagi reti -emparu kedua?	-iya tekenyit lebuh tetemuka emparu baruh tangga-
nama chunto ayat bagi -emparu ti ngena reti kedua?	-aki munuh emparu nya ngena duku-
beri chunto ayat ngena reti -emparu ti bukai.	-kaki iya telih dipantuk emparu.-
padahka chunto ayat ti ngena reti -emparu kedua.	-emparu selalu belalai belah babas-
ulih nuan nerangka pasal raban jaku iban?	raban jaku bisi empat iti bagi.
terangka pasal raban jaku iban.	raban jaku dibagi nitih ka penuduk sida dalam rambai jaku.
ajar pasal raban jaku iban.	raban jaku tebagi ngagai empat bengkah.
terangka pasal raban jaku iban.	bengkah ti keterubah iya nya jaku nama.
padahka pasal raban jaku iban.	raban jaku dibagi nitih ka penuduk sida dalam ayat.
ajar aku pasal raban jaku iban.	kriteris sintaksis dikena dalam magi leka jaku ngagai siti-siti raban.
nama utai raban jaku iban nya?	seleka jaku tau masuk ngagai lebih ari siti raban.
raban jaku iban?	raban jaku tu bisi empat iti bagi.
raban jaku iban nya baka ni?	raban jaku bisi empat bengkah.
nama raban jaku iban nya?	chara magi raban jaku iya nya nitihka penuduk iya di dalam ayat.
nama bengkah ti bisi dalam raban jaku?	enti dibagi ngena chara kasar, raban jaku tebagi ngagai jaku nama, jaku pengawa, jaku adjektif enggau jaku tugas.
nama bengkah bagi raban jaku?	empat bengkah raban jaku iya nya jaku nama, jaku pengawa, jaku adjektif, jaku tugas.
raban jaku tebagi ngagai bengkah nama?	jaku pengawa, jaku nama, jaku adjektif enggau jaku tugas.
raban jaku nya bisi tebagi ngagai siti-siti bengkah?	bengkah bagi raban jaku iya nya jaku nama, jaku pengawa, jaku tugas enggau jaku adjektif.
padahka aku pasal bengkah raban jaku.	antara bengkah raban jaku bisi jaku nama, jaku adjektif, jaku pengawa enggau jaku tugas.
ajar pasal bengkah raban jaku.	jaku nama, jaku tugas, jaku adjektif enggau jaku tugas nya antara bengkah raban jaku.
bengkah dalam raban jaku nya bisi nama?	antara bagi raban jaku nyengkaum jaku tugas, jaku adjektif, jaku nama enggau jaku pengawa.
padahka pasal bengkah raban jaku iban.	bengkah raban jaku ti bisi iya nya jaku tugas, jaku adjektif, jaku pengawa enggau jaku nama.
bengkah raban jaku iban nya baka ni?	bagi raban jaku iya nya jaku tugas, jaku pengawa, jaku adjektif enggau jaku nama.
nama antara bengkah raban jaku iban ti bisi?	raban jaku tebagi ngagai jaku pengawa, jaku adjektif, jaku tugas enggau jaku nama.
terangka pasal raban jaku nama.	jaku nama dikena nyebut nama mensia, jelu, indu utai, endur, barang enggau ti bukai.
baka ni raban jaku nama nya?	dikena nyebut nama mensia, jelu, indu utai, barang, endur enggau ti bukai.
raban jaku nama nya baka ni?	nama mensia, jelu, indu utai, barang tauka endur disebut ngena jaku nama.
ajar pasal raban jaku nama.	jaku nama nya pugu ke rambai jaku nama.
padahka pasal raban jaku nama.	dalam rambai jaku nama, jaku nama nya nyadika pugu.
raban jaku nama?	jaku nama bisi tebagi ngagai tiga bengkah.
raban jaku nama nya baka ni?	jaku nama bisi tiga bengkah.
nama bengkah ti bisi dalam raban jaku nama?	bengkah jaku nama ti bisi iya nya jaku nama tetap, jaku nama rama enggau jaku ganti nama.
raban jaku nama tebagi ngagai nama bengkah?	jaku nama tetap, jaku nama rama enggau jaku ganti nama.
padahka bengkah ti bisi dalam jaku nama.	jaku nama rama, jaku ganti nama enggau jaku nama tetap nya antara bengkah jaku nama.
ajar pasal bengkah dalam raban jaku nama.	jaku nama tebagi ngagai jaku nama tetap, jaku nama rama enggau jaku ganti nama.
bengkah dalam raban jaku nama?	bagi jaku nama nya iya jaku nama rama, jaku nama tetap enggau jaku ganti nama.
baka ni enggau bengkah ti bisi dalam raban jaku nama?	jaku ganti nama, jaku nama tetap enggau jaku nama rama nya antara bagi jaku nama.
terangka bengkah dalam raban jaku nama.	jaku nama nyengkaum jaku ganti nama, jaku nama tetap enggau jaku nama rama.
terangka pasal raban jaku pengawa.	jaku pengawa bisi dua bengkah.
baka ni raban jaku pengawa nya?	jaku pengawa tebagi ngagai dua bengkah.
raban jaku pengawa nya baka ni?	jaku pengawa bisi dua bagi.
ajar pasal raban jaku pengawa.	jaku pengawa tu leka jaku ti nyadi pugu ba rambai jaku pengawa.
padahka pasal raban jaku pengawa.	leka jaku ti nyadi pugu ba rambai jaku pengawa nya jaku pengawa.
raban jaku pengawa?	jaku pengawa ngembuan dua bengkah.
raban jaku pengawa nya baka ni?	jaku pengawa tu bisi dua bagi.
nama bengkah ti bisi dalam raban jaku pengawa?	jaku pengawa dibagi ngagai jaku pengawa intrasitif enggau jaku pengawa transitif.
raban jaku pengawa tebagi ngagai nama bengkah?	jaku pengawa intrasitif enggau jaku pengawa transitif.
padahka bengkah ti bisi dalam jaku pengawa.	dua bagi jaku pengawa iya jaku pengawa intrasitif enggau transitif.
ajar pasal bengkah dalam raban jaku pengawa.	jaku pengawa nyengkaum jaku pengawa transitif enggau intrasitif.
bengkah dalam raban jaku pengawa?	jaku pengawa intrasitif enggau transitif nya bagi ti bisi dalam jaku pengawa.
baka ni enggau bengkah ti bisi dalam raban jaku pengawa?	dua bengkah jaku pengawa nyengkaum jaku pengawa transitif enggau intrasitif.
terangka bengkah dalam raban jaku pengawa.	dua bagi ti bisi dalam jaku pengawa iya nya jaku pengawa intrasitif enggau transitif.
terangka pasal raban jaku adjektif.	jaku adjektif tu dikena nyeritaka jaku nama.
baka ni raban jaku adjektif nya?	jaku nama dicheritaka ngena jaku adjektif.
raban jaku adjektif nya baka ni?	jaku adjektif tu guna iya nyeritaka jaku nama.
ajar pasal raban jaku adjektif.	jaku nama tu dikena nyerita jaku adjektif.
padahka siti chunto jaku adjektif.	chunto leka jaku adjektif iya nya -lebat.
beri siti chunto leka jaku adjektif.	siti chunto bagi jaku adjektif iya nya linggar.
baka ni chunto jaku adjektif.	chunto jaku adjektif iya nya -manah.
nama bengkah ti bisi dalam raban jaku adjektif?	antara bengkah jaku adjektif iya jaku adjektif gaya.
raban jaku adjektif tebagi ngagai nama bengkah?	jaku adjektif gaya, chura, sukat enggau tukuh nya antara bengkah ti bisi dalam jaku adjektif.
padahka bengkah ti bisi dalam jaku adjektif.	jaku adjektif maya, seraka enggau emosi nya antara bagi jaku adjektif.
ajar pasal bengkah dalam raban jaku adjektif.	antara bagi jaku adjektif nyengkaum jaku adjektif chura, maya, chara enggau emosi.
bengkah dalam raban jaku adjektif?	bengkah ti bisi dalam jaku adjektif nyengkaum jaku adjektif asai, tukuh, gaya enggau sukat.
baka ni enggau bengkah ti bisi dalam raban jaku adjektif?	bansa jaku adjektif ti bisi iya nya jaku adjektif seraka, emosi enggau asai.
terangka bengkah dalam raban jaku adjektif.	jaku adjektif emosi, seraka enggau asai nya antara bansa jaku adjektif.
terangka pasal raban jaku tugas.	jaku tugas semina bisi reti ti nyenggala enti dikena begembar enggau raban jaku bukai.
baka ni raban jaku tugas nya?	sekeda jaku tugas nadai mai reti enti dikena meali-ali.
raban jaku tugas nya baka ni?	jaku tugas nadai meri reti enti enda dikena begembar enggau raban jaku bukai.
ajar pasal raban jaku tugas.	raban jaku bukai dikena enggau jaku tugas ngambika iya bisi reti.
padahka pasal raban jaku tugas.	raban jaku tugas mesti dikena enggau raban jaku bukai ngambika iya bisi reti.
raban jaku tugas?	enti jaku tugas dikena meali-ali, iya nadai reti.
raban jaku tugas nya baka ni?	jaku tugas dikena begembar enggau raban jaku bukai baka jaku nama ngambika iya ngembuan reti.
nama bengkah ti bisi dalam raban jaku tugas?	antara bengkah jaku tugas iya nya jaku penyambung ayat enggau jaku tekenyit.
raban jaku tugas tebagi ngagai nama bengkah?	jaku tanya, jaku pun ayat enggau jaku perintah nya antara bengkah ti bisi dalam jaku tugas.
padahka bengkah ti bisi dalam jaku tugas.	jaku penguat, jaku sangkal enggau jaku penekan nya antara bagi jaku tugas.
ajar pasal bengkah dalam raban jaku tugas.	antara bagi jaku tugas nyengkaum jaku tugas chura, maya, chara enggau emosi.
bengkah dalam raban jaku tugas?	bengkah ti bisi dalam jaku tugas nyengkaum jaku tugas perintah, jaku tanya enggau jaku tekenyit.
baka ni enggau bengkah ti bisi dalam raban jaku tugas?	bansa jaku tugas ti bisi iya nya jaku perintah, pemadah enggau jaku adap.
terangka bengkah dalam raban jaku tugas.	jaku perintah, jaku tanya enggau jaku penyambung ayat nya antara bansa jaku tugas.
baka ni gaya jaku pengawa nya?	raban jaku pengawa tu leka jaku ti nyadi pugu ba rambai jaku pengawa.
aku ka nemu pasal jaku pengawa.	jaku pengawa tok dikena nyadi pugu ba rambai jaku pengawa.
baka ni atur jaku pengawa deh?	jaku pengawa bisi dua iti bengkah iya nya jaku pengawa intrasitif enggau jaku pengawa transitif.
bakani baka jaku pengawa nya?	utai ti nyadi tauka dikereja disebut ngena jaku pengawa.
terangka lebih agi pasal jaku pengawa.	jaku pengawa tu dikena lebuh deka nerangka pengawa ti dikereja tauka utai ti nyadi.
padahka siti chunto leka jaku pengawa.	chunto jaku pengawa iya nya -makai.
beri aku siti chunto bagi jaku pengawa.	-muji nya siti chunto jaku pengawa.
baka ni chunto jaku pengawa.	-makai enggau -muji nya chunto jaku pengawa.
chunto jaku pengawa?	siti chunto jaku pengawa iya nya -nyumai.
jaku pengawa nya baka ni chunto iya?	chunto bagi jaku pengawa iya nya -nyipak.
baka ni gaya jaku pengawa transitif nya?	jaku pengawa transitif nya jaku pengawa ti mesti ditangkan enggau jaku nama.
aku ka nemu pasal jaku pengawa transitif.	penyambut ari jaku nama dikena nangkanka jaku pengawa.
baka ni atur jaku pengawa transitif deh?	jaku pengawa ditangkanka jaku nama ti nyadi penyambut.
bakani baka jaku pengawa transitif nya?	jaku pengawa dikena enggau jaku nama ti nyadi penyambut iya.
terangka lebih agi pasal jaku pengawa transitif.	jaku pengawa trasitif tu jaku pengawa ti dikena betangkanka jaku nama.
beri siti ayat jaku pengawa transitif.	-manuk makai jagung.
ajar aku siti ayat ti ngena jaku pengawa transitif.	-indai muji pemutus peresa jimbat.
baka ni chunto ayat ti ngena jaku pengawa transitif?	-aku nyumai asi ke makai lemai.
chunto ayat bagi jaku pengawa transitif?	-kaki iya kembai dibai nyipak bol.
chunto ayat ngena jaku pengawa intrasitif?	-polis nya meresa beg iya.
meri aku siti rambai jaku ti ngena jaku pengawa transitif.	-imba nyabak sesedan laban dianu apai iya.
nama chunto rambai jaku ti ngena jaku pengawa transitif?	-iya tinduk sehari-hari laban buntau.
meri aku chunto ayat ngena jaku pengawa transitif.	-aku makai sayur ngambika tubuh gerai.
baka ni gaya jaku pengawa intrasitif nya?	jaku pengawa intrasitif nya jaku pengawa ti nadai nerima jaku nama nyadi objek iya.
aku ka nemu pasal jaku pengawa intrasitif.	jaku pengawa intrasitif tu diimbai enggau rentayan jaku penerang ti nyadika penembu ayat iya.
baka ni atur jaku pengawa intrasitif deh?	dalam jaku pengawa intrasitif, raban jaku nadai nerima objek terus.
bakani baka jaku pengawa intrasitif nya?	jaku pengawa intrasitif tebagi ngagai bepenembu enggau enda bepenembu.
terangka lebih agi pasal jaku pengawa intrasitif.	jaku pengawa intrasitif tu bisi dua bengkah iya nya bepenembu enggau nadai bepenembu.
jaku pengawa intrasitif nya baka ni?	nadai objek diterima terus dalam raban jaku pengawa intrasitif.
padahka lebih agi pasal jaku pengawa intrasitif.	jaku intrasitif tau diimbai ngena rentayan jaku penerang.
beri siti ayat jaku pengawa intransitif bepenembu.	-aki diau di rumah panjai.
ajar aku siti ayat ti ngena jaku pengawa intransitif bepenembu.	-aku udah belinsur gerai.
baka ni chunto ayat ti ngena jaku pengawa intransitif bepenembu?	-orang tesat nya belangkau serudu ngena daun.
chunto ayat bagi jaku pengawa intransitif bepenembu?	-imba nyadi tuai rumah taun 2022 ila.
chunto ayat ngena jaku pengawa intrasitif?	-seduai iya kawin bulan nyin ila.
meri aku siti rambai jaku ti ngena jaku pengawa intransitif bepenembu.	-apai indai iya sarak kemari.
nama chunto rambai jaku ti ngena jaku pengawa intransitif bepenembu?	-iya nyabak sesedan laban takut.
meri aku chunto ayat ngena jaku pengawa intransitif bepenembu.	-limbi benung nulis surat ngagai kaban iya.
beri siti ayat jaku pengawa intransitif enda bepenembu.	-linggi tuchum.
ajar aku siti ayat ti ngena jaku pengawa intransitif enda bepenembu.	-indai ketawa.
baka ni chunto ayat ti ngena jaku pengawa intransitif enda bepenembu?	-jambi udah pulai.
chunto ayat bagi jaku pengawa intransitif enda bepenembu?	-sidi meda madi iya nyabak.
chunto ayat ngena jaku pengawa intrasitif enda bepenembu?	-aku tinduk.
meri aku siti rambai jaku ti ngena jaku pengawa intransitif enda bepenembu.	-pengajar nya benung nulis.
nama chunto rambai jaku ti ngena jaku pengawa intransitif enda bepenembu?	-seduai iya enda ngetu bejaku.
meri aku chunto ayat ngena jaku pengawa intransitif enda bepenembu.	-indai udah bejalai.
nama bengkah jaku nama ti bisi?	jaku nama tebagi ngagai jaku nama tetap, jaku nama rama enggau jaku ganti nama.
bengkah bagi jaku nama?	antara bengkah jaku nama iya nya jaku nama tetap, jaku nama rama enggau jaku ganti nama.
padahka bagi jaku nama ti bisi.	jaku nama tetap, jaku nama rama enggau jaku ganti nama nya antara bagi jaku nama.
beri bengkah ti bisi dalam jaku nama.	jaku nama bisi tiga bansa iya jaku nama tetap, jaku nama rama enggau jaku ganti nama.
jaku nama bisi berapa bengkah?	jaku nama tetap, jaku nama rama enggau jaku ganti nama.
nama bengkah bagi jaku nama?	tiga bansa jaku nama iya nya jaku nama rama, jaku nama tetap enggau jaku ganti nama.
jaku nama nya bisi dibagi ngagai berapa bengkah?	tiga bengkah jaku nama iya nya jaku nama tetap, jaku nama rama enggau jaku ganti nama.
nama bagi jaku nama ti ditemu nuan?	jaku nama bisi tiga bagi iya nya jaku ganti nama, jaku nama tetap enggau jaku nama rama.
nuan nemu bengkah ti bisi bagi jaku nama?	jaku nama dibagi ngagai tiga bansa iya nya jaku ganti nama, jaku nama tetap enggau jaku nama rama.
padah bengkah ti bisi bagi jaku nama.	jaku nama tetap, jaku nama rama enggau jaku ganti nama nya tiga bansa ti bisi dalam jaku nama.
terangka pasal jaku nama tetap.	jaku nama tetap tu nama ti diberi ngagai utai idup enda ngira iya mensia tauka ukai mensia.
baka ni jaku nama tetap nya?	jaku nama tetap nya tukuh jaku ti dikena nyebut nama mensia, endur, jwlu, pekakas, gerempung, pangkat enggau ti bukai.
padahka pasal jaku nama tetap	tukuh jaku nama ditulis bepunka urup besai enda ngira endur iya dikena dalam ayat.
terangka jaku nama tetap.	jaku nama tetap dibagi ngagai jaku nama tetap idup enggau jaku nama tetap ukai idup.
jaku nama tetap?	jaku nama tetap idup dibagi ngagai jaku nama tetap idup mensia enggau jaku nama tetap idup ukai mensia.
nama chunto bagi jaku nama tetap idup mensia?	chunto jaku nama tetap idup mensia iya nya nama orang baka -Entinggi.
beri siti chunto jaku nama tetap idup mensia?	chunto jaku nama tetap idup mensia iya nya nama apai baka -Garan.
padahka siti chunto jaku nama tetap idup mensia.	chunto jaku nama tetap idup mensia iya nya nama kaban nuan baka -Jugah.
siti chunto bagi jaku nama tetap idup mensia.	chunto jaku nama tetap idup mensia iya nya nama menyadi baka -Bale.
meri aku siti chunto jaku nama tetap idup mensia.	chunto jaku nama tetap idup mensia iya nya nama bini nuan baka -Limah.
nama chunto bagi jaku nama tetap idup ukai mensia?	chunto jaku nama tetap idup ukai mensia iya nya nama ukui baka -Sengkalan.
beri siti chunto jaku nama tetap idup ukai mensia?	chunto jaku nama tetap idup ukai mensia iya nya nama mayau baka -Sabit.
padahka siti chunto jaku nama tetap idup ukai mensia.	chunto jaku nama tetap idup ukai mensia iya nya nama manuk sabung nuan baka -Biring.
siti chunto bagi jaku nama tetap idup ukai mensia.	chunto jaku nama tetap idup ukai mensia iya nya nama antu baka -Antu Rayau.
meri aku siti chunto jaku nama tetap idup ukai mensia.	chunto jaku nama tetap idup ukai mensia iya nya nama malikat baka -Gabriel.
nama chunto bagi jaku nama tetap idup ukai?	chunto jaku nama tetap ukai idup iya nya nama gerempung baka -Gerempung Pekebun Song.
beri siti chunto jaku nama tetap idup ukai?	chunto jaku nama tetap ukai idup iya nya nama endur baka -Kota Samarahan.
padahka siti chunto jaku nama tetap idup ukai.	chunto jaku nama tetap ukai idup iya nya nama bansa nuan baka -Iban.
siti chunto bagi jaku nama tetap idup ukai.	chunto jaku nama tetap ukai idup iya nya nama jaku baka -Jaku Iban.
meri aku siti chunto jaku nama tetap idup ukai.	chunto jaku nama tetap ukai idup iya nya nama pangkat baka -Datuk Patinggi.
terangka pasal jaku nama rama.	jaku nama rama dikena nyebut sesebengkah pekara enggau utai rama.
baka ni jaku nama rama nya?	utai rama idup enggau ukai idup disebut ngena jaku nama rama.
padahka pasal jaku nama rama	jaku nama rama tebagi ngagai jaku nama rama idup enggau ukai idup.
terangka jaku nama rama.	jaku nama rama idup tebagi ngagai mensia enggau ukai mensia.
jaku nama rama?	jaku nama rama ukai idup tebagi ngagai institusi enggau ukai institusi.
terangka pasal jaku nama rama idup mensia.	jaku nama rama idup mensia dikena nyebut nama ti madahka bengkah pengawa mensia.
baka ni jaku nama rama idup mensia nya?	lebuh madahka bengkah kereja tauka pengawa mensia, kita ngena jaku nama rama idup mensia.
nama chunto bagi jaku nama rama idup mensia?	chunto jaku nama rama idup mensia iya nya pengawa baka -penulis.
beri siti chunto jaku nama rama idup mensia?	-pengajar nya chunto jaku nama rama idup mensia.
padahka siti chunto jaku nama rama idup mensia.	-polis, -doktor enggau -posmen.
siti chunto bagi jaku nama rama idup mensia.	siti chunto jaku nama rama idup mensia iya nya kerani.
meri aku siti chunto jaku nama rama idup mensia.	chunto bagi jaku nama rama idup mensia iya nya -lemambang.
nama chunto bagi jaku nama rama ukai idup mensia?	chunto jaku nama rama idup ukai mensia iya nya jelu baka -manuk.
beri siti chunto jaku nama rama ukai idup mensia?	-ukui nya chunto jaku nama rama idup ukai mensia bagi jelu.
padahka siti chunto jaku nama rama ukai idup mensia.	-chapi, -bangau enggau -baya.
siti chunto bagi jaku nama rama ukai idup mensia.	siti chunto utai tumbuh bagi jaku nama rama idup ukai mensia iya nya rumput.
meri aku siti chunto jaku nama rama ukai idup mensia.	chunto bagi jaku nama rama idup ukai mensia bagi utai tumbuh iya nya -bungai.
nama chunto bagi jaku nama rama institusi?	chunto jaku nama rama institusi iya nya -sekula.
beri siti chunto jaku nama rama institusi?	-balai polis nya chunto jaku nama rama institusi.
padahka siti chunto jaku nama rama institusi.	-tadika, -gerempung enggau -universiti.
siti chunto bagi jaku nama rama institusi.	siti chunto jaku nama rama institusi iya nya klinik.
meri aku siti chunto jaku nama rama institusi.	chunto bagi jaku nama rama institusi iya nya -hospital.
nama chunto bagi jaku nama rama ukai institusi?	chunto jaku nama rama ukai institusi iya nya -sungai.
beri siti chunto jaku nama rama ukai institusi?	-umai nya chunto jaku nama rama ukai institusi.
padahka siti chunto jaku nama rama ukai institusi.	-kedai, -bukit enggau -jalai.
siti chunto bagi jaku nama rama ukai institusi.	siti chunto jaku nama rama ukai institusi iya nya padang.
meri aku siti chunto jaku nama rama ukai institusi.	chunto bagi jaku nama rama ukai institusi iya nya -dapur.
terangka pasal jaku ganti nama.	jaku ganti nama tu dikena nganti jaku nama.
baka ni jaku ganti nama nya?	jaku nama diganti ngena jaku ganti nama.
padahka pasal jaku ganti nama	lebuh kitai nganti jaku nama, jaku ganti nama dikena.
terangka jaku ganti nama.	jaku ganti nama tebagi ngagai jaku ganti nama orang, penunjuk, tempat enggau adap.
jaku ganti nama?	jaku ganti nama orang, penunjuk, tempat enggau adap nya antara bagi jaku ganti nama.
terangka pasal jaku ganti nama orang.	jaku ganti nama orang dibagi ngagai jaku ganti nama orang kesatu, kedua, ketiga enggau orang pengempu.
baka ni jaku ganti nama orang nya?	antara bengkah jaku ganti nama iya nya jaku ganti nama orang pengempu, kesatu, kedua enggau ketiga.
terangka pasal jaku ganti nama orang pengempu.	jaku ganti nama orang pegempu tu dikena nganti nama orang ke ngempu.
baka ni jaku ganti nama orang pengempu nya?	nama orang ti ngempu diganti enggau jaku ganti nama orang pengempu.
nama chunto bagi jaku ganti nama orang orang pengempu?	chunto jaku ganti nama orang pengempu iya nya -engku.
beri siti chunto jaku ganti nama orang orang pengempu?	-engkami.
padahka siti chunto jaku ganti nama orang orang pengempu.	siti chunto bagi jaku ganti nama orang pengempu iya nya -engkita.
siti chunto bagi jaku ganti nama orang orang pengempu.	antara chunto bagi jaku ganti nama orang pengempu iya nya -engku enggau -engkami.
meri aku siti chunto jaku ganti nama orang orang pengempu.	-engkitai nya antara chunto bagi jaku ganti nama orang pengempu.
terangka pasal jaku ganti nama kesatu.	jaku ganti nama orang kesatu tu dikena nganti nama orang ti bejaku.
baka ni jaku ganti nama kesatu nya?	orang ti bejaku diganti ngena jaku ganti nama orang kesatu.
nama chunto bagi jaku ganti nama orang kesatu?	chunto jaku ganti nama orang kesatu iya nya -aku.
beri siti chunto jaku ganti nama orang kesatu?	-kami.
padahka siti chunto jaku ganti nama orang kesatu.	siti chunto bagi jaku ganti nama orang kesatu iya nya -kitai.
siti chunto bagi jaku ganti nama orang kesatu.	antara chunto bagi jaku ganti nama orang kesatu iya nya -aku enggau -kitai.
meri aku siti chunto jaku ganti nama orang kesatu.	-tua nya antara chunto bagi jaku ganti nama orang kesatu.
terangka pasal jaku ganti nama orang kedua.	jaku ganti nama orang kedua tu dikena nganti nama orang ti berandau enggau kitai.
baka ni jaku ganti nama orang kedua nya?	kita ngena jaku ganti nama kedua dikena nganti nama orang ti berandau enggau kitai.
nama chunto bagi jaku ganti nama orang orang kedua?	chunto jaku ganti nama orang kedua iya nya -nuan.
beri siti chunto jaku ganti nama orang orang kedua?	-dek.
padahka siti chunto jaku ganti nama orang orang kedua.	siti chunto bagi jaku ganti nama orang kedua iya nya -kita.
siti chunto bagi jaku ganti nama orang orang kedua.	antara chunto bagi jaku ganti nama orang kedua iya nya -nuan enggau -dek.
meri aku siti chunto jaku ganti nama orang orang kedua.	-seduai nya antara chunto bagi jaku ganti nama orang kedua.
terangka pasal jaku ganti nama orang ketiga.	jaku ganti nama orang ketiga tu dikena nganti nama orang ti dikenang lebuh kitai berandau enggau orang bukai.
baka ni jaku ganti nama orang ketiga nya?	lebuh bekenang ke orang bukai dalam randau, kitai nguna jaku ganti nama orang ketiga.
nama chunto bagi jaku ganti nama orang orang ketiga?	chunto jaku ganti nama orang ketiga iya nya -iya.
beri siti chunto jaku ganti nama orang orang ketiga?	-sida.
padahka siti chunto jaku ganti nama orang orang ketiga.	siti chunto bagi jaku ganti nama orang ketiga iya nya -sanu.
siti chunto bagi jaku ganti nama orang orang ketiga.	antara chunto bagi jaku ganti nama orang ketiga iya nya -iya enggau -sida.
meri aku siti chunto jaku ganti nama orang orang ketiga.	-sida nya antara chunto bagi jaku ganti nama orang ketiga.
nama chunto bagi jaku ganti nama penunjuk chunto?	chunto jaku ganti nama penunjuk iya nya -tu.
beri siti chunto jaku ganti nama penunjuk chunto?	-nya.
padahka siti chunto jaku ganti nama penunjuk chunto.	siti chunto bagi jaku ganti nama penunjuk iya nya -nyin.
siti chunto bagi jaku ganti nama penunjuk chunto.	antara chunto bagi jaku ganti nama penunjuk iya nya -nya enggau -nyin.
meri aku siti chunto jaku ganti nama penunjuk chunto.	-tu nya antara chunto bagi jaku ganti nama penunjuk.
nama chunto bagi jaku ganti nama tempat?	chunto jaku ganti nama tempat iya nya -ditu.
beri siti chunto jaku ganti nama tempat?	-dia.
padahka siti chunto jaku ganti nama tempat.	siti chunto bagi jaku ganti nama tempat iya nya -din.
siti chunto bagi jaku ganti nama tempat.	antara chunto bagi jaku ganti nama tempat iya nya -din enggau -dia.
meri aku siti chunto jaku ganti nama tempat.	-ditu nya antara chunto bagi jaku ganti nama tempat.
nama chunto bagi jaku ganti nama adap?	chunto jaku ganti nama adap iya nya -kitu.
beri siti chunto jaku ganti nama adap?	-kin.
padahka siti chunto jaku ganti nama adap.	siti chunto bagi jaku ganti nama adap iya nya -kia.
siti chunto bagi jaku ganti nama adap.	antara chunto bagi jaku ganti nama adap iya nya -kitu enggau -kia.
meri aku siti chunto jaku ganti nama adap.	-kin nya antara chunto bagi jaku ganti nama adap.
terangka pasal atur jaku nama.	atur ngaga jaku nama bisi tiga tukuh iya nya jaku nama tunggal, tumbuh enggau turu.
baka ni atur jaku nama nya?	jaku nama tunggal, tumbuh enggau turu nya antara tukuh dalam atur ngaga jaku nama.
padahka pasal atur jaku nama	antara tiga tukuh dalam atur ngaga jaku nama iya nya jaku nama tunggal, tumbuh enggau turu.
terangka atur jaku nama.	dalam atur ngaga jaku nama, tiga tukuh ti bisi nya nya jaku nama tunggal, tumbuh enggau turu.
atur jaku nama?	tiga tukuh dalam atur ngaga jaku nama iya nya jaku nama tunggal, tumbuh enggau turu.
terangka pasal atur jaku nama tunggal.	jaku nama tunggal tu digaga ari seleka jaku.
baka ni atur jaku nama tunggal nya?	jaku nama ti dipenyadi ari seleka jaku nya dikumbai jaku tunggal.
nama chunto bagi jaku nama tunggal?	chunto jaku nama tunggal iya nya -keli.
beri siti chunto jaku nama tunggal?	-rumah.
padahka siti chunto jaku nama tunggal.	siti chunto bagi jaku nama tunggal iya nya -tanah.
siti chunto bagi jaku nama tunggal.	antara chunto bagi jaku nama tunggal iya nya -burung enggau -selapuk.
meri aku siti chunto jaku nama tunggal.	-kampung nya antara chunto bagi jaku nama tunggal.
terangka pasal atur jaku nama tumbuh.	jaku nama tumbuh tu jaku ti nyadi ari proses meri penambah ngagai urat jaku.
baka ni atur jaku nama tumbuh nya?	-pen, -ke enggau -se nya sekeda ari penambah ti dikena dalam jaku nama tumbuh.
nama chunto bagi jaku nama tumbuh?	leka jaku -penemu nya antara chunto jaku nama tumbuh ti ngena penambah -pen.
beri siti chunto jaku nama tumbuh?	leka jaku -kedua nya antara chunto jaku nama tumbuh ti ngena penambah -ke.
padahka siti chunto jaku nama tumbuh.	leka jaku -serumah nya antara chunto jaku nama tumbuh ti ngena penambah -se.
siti chunto bagi jaku nama tumbuh.	leka jaku -pelajar nya antara chunto jaku nama tumbuh ti ngena penambah -pel.
meri aku siti chunto jaku nama tumbuh.	leka jaku -pelayar nya antara chunto jaku nama tumbuh ti ngena penambah -pe.
terangka pasal atur jaku nama turu.	jaku nama turu tu nyadi ari proses dua tauka lebih leka jaku ti berimbai lalu mai reti ti baru.
baka ni atur jaku nama turu nya?	lebuh lebih ari dua leka jaku berimbai, jaku nama turu tu nyadi lalu mai reti ti baru.
padahka pasal atur jaku nama turu	jaku nama turu bisi empat bengkah.
terangka atur jaku nama turu.	jaku nama turu dibagi ngagai empat bansa.
atur jaku nama turu?	jaku nama turu bisi empat bansa.
nama bengkah ti bisi bagi jaku nama turu?	empat bansa jaku nama turu iya nya jaku nama turu meali-ali, besilup, gelar orang enggau penemu.
padahka bengkah bagi jaku nama turu.	jaku nama turu meali-ali, besilup, gelar orang enggau penemu nya bengkah jaku nama turu.
terangka pasal atur jaku nama meali-ali.	jaku nama turu meali-ali tu nyadi ari dua tauka lebih leka jaku ti meali-ali.
baka ni atur jaku nama meali-ali nya?	dua tauka lebih leka jaku ti meali-ali nya asal jaku nama turu meali-ali.
nama chunto bagi jaku nama turu meali-ali?	chunto jaku nama turu meali-ali iya nya -tuai rumah.
beri siti chunto jaku nama turu meali-ali?	-balai raya.
padahka siti chunto jaku nama turu meali-ali.	siti chunto bagi jaku nama turu meali-ali iya nya -tengah hari.
siti chunto bagi jaku nama turu meali-ali.	antara chunto bagi jaku nama turu meali-ali iya nya -sumpit lachau enggau -tai lalat.
meri aku siti chunto jaku nama turu meali-ali.	-tinga pelanduk nya antara c
terangka pasal atur jaku nama turu gelar orang.	jaku nama turu gelar orang dikena enggau chara rasmi dikena nunjukka pangkat.
baka ni atur jaku nama turu gelar orang.	jaku nama turu gelar orang diberi ngena chara rama dikena nunjukka status sosial.
nama chunto bagi jaku nama turu gelar orang?	chunto jaku nama turu gelar orang iya nya -Orang Kaya Pemancha.
beri siti chunto jaku nama turu gelar orang?	-Datuk Patinggi.
padahka siti chunto jaku nama turu gelar orang.	siti chunto bagi jaku nama turu gelar orang iya nya -Profesor Diraja.
siti chunto bagi jaku nama turu gelar orang.	antara chunto bagi jaku nama turu gelar orang iya nya -Datuk Patinggi enggau -Penghulu Dalam.
meri aku siti chunto jaku nama turu gelar orang.	-Leftenan Jeneral nya antara chunto bagi jaku nama turu gelar orang.
terangka pasal atur jaku nama turu penemu.	jaku nama turu penemu tu dikena nerangka konsep dalam siti-siti penemu.
baka ni atur jaku nama turu penemu.	konsep dalam siti-siti penemu diterangka ngena jaku nama turu penemu.
nama chunto bagi jaku nama turu penemu?	chunto jaku nama turu penemu iya nya -segi empat sama.
beri siti chunto jaku nama turu penemu?	-jaku pengawa transitif.
padahka siti chunto jaku nama turu penemu.	siti chunto bagi jaku nama turu penemu iya nya -ujan asid.
siti chunto bagi jaku nama turu penemu.	antara chunto bagi jaku nama turu penemu iya nya -pengidup siga enggau -ujan asid.
meri aku siti chunto jaku nama turu penemu.	-tepung pegembai nya antara chunto bagi jaku nama turu penemu.
terangka pasal atur jaku nama turu besilup.	jaku nama turu besilup tu mai reti besilup baka jaku sempama.
baka ni atur jaku nama turu besilup.	jaku nama turu tu baka jaku sempama ti mai reti besilup.
nama chunto bagi jaku nama turu besilup?	chunto jaku nama turu besilup iya nya -aum juak.
beri siti chunto jaku nama turu besilup?	-ati hari.
padahka siti chunto jaku nama turu besilup.	siti chunto bagi jaku nama turu besilup iya nya -buai batu.
siti chunto bagi jaku nama turu besilup.	antara chunto bagi jaku nama turu besilup iya nya -buai batu enggau -buah jari.
meri aku siti chunto jaku nama turu besilup.	-kumang menyarung nya antara chunto bagi jaku nama turu besilup.
nuan nemu pasal jaku adjektif?	jaku adjektif tu dikena madahka tauka nyeritaka jaku nama.
padahka aku pasal jaku adjektif.	jaku adjektif dikena nerangka gaya enggau gamal utai ti konkrit tauka abstrak.
nama chunto jaku adjektif?	chunto leka jaku adjektif iya nya 'pabu'.
chunto jaku adjektif?	chunto leka jaku adjektif iya nya 'manah'.
beri aku siti ayat ti ngena jaku adjektif.	manah amat gamal indu nya.
beri siti chunto ayat ti nguna jaku adjektif.	sungai tu pabu.
terangka ngagai aku pasal jaku tugas.	jaku tugas tu dikena begembar enggau raban jaku baru iya ulih mai reti ti nyenggala.
ulih nuan ngajar aku pasal jaku tugas?	jaku tugas ulih mai reti enti dikena dalam rambai jaku.
ajar aku pasal jaku tugas.	jaku tugas semina beguna nyadika sanding jaku nama.
nama reti jaku tugas nya?	jaku tugas enda ulih meri reti menyana enti dikena kediri.
jaku tugas dibagi ngagai berapa bengkah?	antara bengkah jaku tugas nya jaku penyambung ayat, jaku tanya, jaku tekenyit, jaku perintah enggau jaku prarambai jaku.
berapa iti bengkah ti bisi ba dalam jaku tugas?	empat bengkah jaku tugas ti ditemu aku iya nya jaku penyambung ayat, jaku tanya, jaku tekenyit, jaku perintah enggau jaku perambai jaku.
nama bengkah ti bisi bagi jaku tugas?	aku mina nemu empat bengkah iya nya jaku penyambung ayat, jaku tanya, jaku perintah, jaku tekenyit enggau jaku perambai jaku.
nama chunto jaku tugas?	chunto jaku tugas iya nya -akai, -apo, -lalu.
meri chunto jaku tugas?	antara chunto jaku tugas iya nya -dini, -kati, -ari ni.
chunto jaku tugas?	-anang, -arapka, -minta enggau -uji.
baka ni chunto jaku tugas?	chunto ti ditemu aku iya nya -amat, -ya, -tau.
nama utai dikumbai jaku tugas penyambung?	jaku ti dikena bekaitka unit jaku baka leka jaku, rambai jaku tauka ayat ngambika meri reti ti lebih besai enggau konsep.
padah pasal jaku tugas penyambung?	jaku tugas dikena dalam rambai jaku ngambika sesiti rambai jaku nya ulih ngembuan konsep enggau reti ti lebih besai.
terangka pasal jaku tugas penyambung?	jaku penyambung dikena dalam ayat ke pandak nyadika penyambung awakka iya nyadi siti ayat turu ti menyana.
jaku tugas penyambung?	jaku penyambung dibagi ngagai dua bengkah.
jaku penyambung bisi dibagi ngagai bengkah?	jaku penyambung bisi dua bagi iya nya jaku penyambung tunggal enggau berentayan.
nama bengkah jaku penyambung ti bisi?	jaku penyambung tunggal enggau berentayan.
jaku penyambung bisi bengkah?	dua bengkah iya nya jaku penyambung tunggal enggau berentayan.
padah bengkah jaku penyambung.	bisi dua bagi iya nya jaku penyambung tunggal enggau berentayan.
terangka pasal jaku penyambung tunggal.	jaku penyambung tunggal nya semina ngena siti leka jaku aja.
baka ni jaku penyambung tunggal nya?	leka jaku ti dikena jaku penyambung tunggal semina siti.
padahka pasal jaku penyambung tunggal.	jaku penyambung tunggal semina nguna siti leka jaku.
beri chunto jaku penyambung tunggal.	chunto jaku penyambung tunggal iya nya -enggau, -semadi, -tang.
chunto jaku penyambung tunggal?	-lebuh, -maya, -lalu
nama chunto bagi jaku penyambung tunggal?	antara chunto jaku penyambung tunggal iya nya -dataika enggau -lalu.
padahka pasal jaku penyambung berentayan.	jaku penyambung berentayan nya bisi dua iti leka jaku.
ajar aku jaku penyambung berentayan nya?	dua iti leka jaku dikena dalam jaku penyambung berentayan.
beri chunto jaku penyambung berentayan.	chunto jaku penyambung berentayan nya -nambahka pia.
chunto jaku penyambung berentayan?	-nya alai enggau - ukai semina.
nama chunto bagi jaku penyambung berentayan?	siti chunto jaku penyambung berentayan iya nya -taja pia.
nama chunto jaku berentayan deh?	antara chunto bagi jaku berentayan iya nya -nya alai.
terangka agai aku baka ni jaku tekenyit nya.	jaku tekenyit nya dikena madahka asai rawan.
jaku tekenyit nya baka ni?	asai rawan, irau tauka takut dipadahka ngena jaku tekenyit.
meri chunto jaku tekenyit.	chunto jaku tekenyit nya akai.
nama chunto jaku tekenyit?	chunto jaku tekenyit nya akai enggau apo.
chunto jaku tekenyit?	antara jaku tekenyit nya nya akai, apo enggau eh.
meri chunto ayat ngena 'akai'.	akai, pedih amat ati aku meda nuan!
nama chunto rambai jaku ngena 'akai'?	akai, telih jari aku!
beri siti ayat ngena jaku tekenyit akai.	akai, pedih amat ditempap nuan!
baka ni ngena jaku tekenyit akai dalam ayat?	akai, enda ingat mai baju aku!
nama chunto ayat ngena 'apo'.	apo, nama gamal nuan pepera?
rambai jaku ngena 'apo'?	apo, lenyau baru barang nuan pia?
padahka siti ayat ngena jaku tekenyit apo.	apo, kemaya nuan datai?
baka ni ngena jaku tekenyit apo dalam ayat?	apo, balat nuan belaya?
tulis chunto ayat ngena 'eh'.	eh, nuan tu bebula!
beri siti ayat ngena 'eh'?	eh, duit iya teberayan!
padahka siti rambai jaku ngena jaku tekenyit eh.	eh, tengkuk ku nuan legi!
baka ni ngena jaku tekenyit eh dalam ayat?	eh, anang nuan takut!
baka ni jaku perintah nya?	jaku perintah nya dikena maya kitai ngasuh orang.
jaku perintah nya baka ni?	jaku perintah dikena ngasuh tauka nagang orang.
padahka ngagai aku pasal jaku perintah.	jaku perintah nya dikena nagang orang.
meri chunto jaku perintah.	chunto jaku perintah iya nya -anang.
nama chunto jaku perintah?	-minta, uji enggau -anang.
chunto jaku perintah?	siti chunto jaku perintah iya nya -anang.
nama chunto leka jaku perintah?	antara chunto jaku perintah iya nya -minta.
meri chunto ayat ngena 'anang'.	-nuan anang belanda.
nama chunto rambai jaku ngena 'anang'?	-anang belagu rerauh.
beri siti ayat ngena jaku perintah anang.	-anang kiruhka iya.
meri aku chunto ayat ti ngena jaku perintah -anang.	-umbas nya, anang nyabak agi.
nama chunto ayat ngena 'uji'.	-uji nuan belajar bebendar.
rambai jaku ngena 'uji'?	-uji gaga tumu pengawa nuan nya.
padahka siti ayat ngena jaku perintah uji.	-uji nuan tinduk.
tulis chunto ayat ngena 'arapka'.	-arapka kitai serumah badu belaya.
beri siti ayat ngena 'arapka'?	-arapka ila tua betemu baru.
padahka siti rambai jaku ngena jaku perintah arapka.	-arapka iya ulih pulai ngagai aku.
tulis chunto ayat ngena 'minta'.	-minta nuan anang ngansak aku.
beri siti ayat ngena 'minta'?	-minta kita anang inggar.
padahka siti rambai jaku ngena jaku perintah minta.	-iya minta aku bebaris.
meri aku chunto ayat ti ngena jaku perintah.	-minta semua orang bediri.
terangka pasal jaku tanya.	jaku tanya dikena lebuh nanyaka berita.
nama utai dikumbai jaku tanya?	lebuh nanyaka berita tauka pesan, kitai nguna jaku tanya.
baka ni chunto leka jaku tanya?	chunto jaku tanya iya nya -ari.
nama chunto leka jaku tanya ke bukai?	chunto jaku tanya iya nya -berapa.
chunto leka jaku tanya?	antara chunto jaku tanya iya nya - ari.
meri aku sigi chunto leka jaku tanya.	-berapa nya chunto leka jaku ti dikumbai jaku tanya.
padahka aku chunto leka jaku tanya.	chunto jaku-tanya iya nya -sapa.
nama chunto leka jaku dalam dikumbai jaku tanya?	antara chunto jaku tanya iya nya -ni.
nama bagi chunto leka jaku tanya?	chunto jaku tanya iya nya -baka.
leka jaku tanya nya baka ni chunto iya?	-dini nya chunto jaku tanya.
meri aku chunto ayat ngena jaku tanya -ari.	ari ni nuan bulih tekuyung nya?
baka ni ngena jaku tanya -ari dalam rambai jaku?	ari ni penatai temuai nya?
chunto ayat ngena jaku tanya -ari?	ari nyin kita mansang tadi?
ayat ngena jaku tanya -ari?	ari kemaya nuan baka tu?
baka ni gaya ayat ngena jaku tanya -berapa.	berapa rega baju tu?
baka ni chara ngena jaku tanya -berapa dalam ayat?	berapa hari nuan ngasu?
chunto ayat ngena jaku tanya -berapa?	berapa kali aku udah madah?
ayat ngena jaku tanya -berapa?	berapa iku anak manuk nya?
baka ni gaya ayat ngena jaku tanya -sapa.	sapa nembiak nya?
baka ni chara ngena jaku tanya -sapa dalam ayat?	sapa ti muai sampah tu?
chunto ayat ngena jaku tanya -sapa?	sapa ti nyabak nya?
ayat ngena jaku tanya -sapa?	sapa ka enggau aku ngagai kebun?
baka ni gaya ayat ngena jaku tanya -ni.	ni bagi anak nuan ditu?
meri aku chunto ayat ngena jaku tanya -ni.	ni utai ko nuan tadi?
baka ni ngena jaku tanya -ni dalam rambai jaku?	ni iya tadi deh?
ayat ngena jaku tanya -ni?	ni peninggi pun tapang nya?
baka ni gaya ayat ngena jaku tanya -baka.	baka ni gamal anak indu nuan?
meri aku chunto ayat ngena jaku tanya -baka.	baka tu rumah nuan?
baka ni ngena jaku tanya -baka dalam rambai jaku?	baka nama gamal unta?
ayat ngena jaku tanya -baka?	baka ni nuan ulih ngaga tu?
baka ni gaya ayat ngena jaku tanya -dini.	dini nuan ngelalaika barang aku?
meri aku chunto ayat ngena jaku tanya -dini.	dini nuan diau?
chunto ayat ngena jaku tanya -dini?	dini nuan bulih sayur tu?
ayat ngena jaku tanya -dini?	dini barang nya tadi?
terangka pasal jaku prarambai jaku.	raban jaku ti dikena sebedau rambai jaku bukai.
nama utai dikumbai jaku prarambai jaku?	jaku prarambai jaku dikena sebedau jaku nama, jaku adjektif enggau jaku pengawa.
nama bengkah jaku prarambai jaku?	jaku bantu, jaku penguat, jaku pengekan enggau jaku sangkal.
padahka antara bengkah ti bisi bagi jaku prarambai jaku.	antara bengkah jaku prarambai jaku iya nya jaku bantu, jaku penguat, jaku pengekan enggau jaku sangkal.
baka ni jaku prarambai bantu?	jaku prarambai bantu dibagi ngagai jaku bantu aspek enggau gaya.
jaku prarambai bantu nya baka ni?	jaku bantu aspek enggau gaya nya bengkah jaku prarambai jaku bantu.
baka ni jaku prarambai bantu gaya?	Dikena lebuh meri penerang ke asai bekaul enggau pengawa ti dikereja.
jaku prarambai bantu gaya nya baka ni?	dikena meri penerang bekaul enggau asai pengawa ti dikereja.
meri aku chunto jaku prarambai jaku bantu gaya.	kami -deka nurun ke umai.
chunto jaku prarambai jaku bantu gaya?	nuan -ulih makai ubat legi.
terangka pasal jaku prarambai penguat.	jaku ti dikena nerangka maya, chara enggau gaya jaku ti dikuatka iya.
jaku prarambai penguat?	maya, chara enggau gaya jaku dikuatka enggau jaku penguat.
nama bengkah jaku penguat?	antara bengkah jaku penguat iya nya berentayan, meali-ali enggau sebarang tempat.
jaku penguat bisi dibagi ngagai bengkah?	jaku penguat berentayan, mealli-ali enggau sebarang tempat nya antara bengkah jaku penguat.
terangka pasal jaku penguat berentayan.	dikena nerangka reti ti nyentuk besereta enggau jaku ti dikuatka.
baka ni jaku penguat berentayan nya?	jaku penguat berentayan mina ulih nerangka reti nyentuk lebuh dikena enggau jaku ti dikuatka iya.
terangka pasal jaku penguat meali-ali.	chunto jaku penguat meali-ali iya nya -nyau.
baka ni jaku penguat meali-ali nya?	-bendar nya antara chunto jaku penguat meali-ali.
terangka pasal jaku penguat sebarang tempat.	jaku penguat sebarang tempat ulih dikena dini-dini dalam ayat baka -amat.
baka ni jaku penguat sebarang tempat nya?	antara chunto jaku penguat sebarang tempat iya nya -amat.
terangka pasal jaku prarambai penekan.	jaku tu dikena ngemeratka pekara ti dikejaku.
jaku prarambai penekan nya baka ni?	jaku prarambai penekan dikena lebuh ka nguatka pekara ti dikejaku.
meri aku chunto jaku prarambai penekan.	antara chunto leka jaku penekan iya nya mih.
chunto jaku prarambai penekan?	chunto leka jaku penekan iya nya -mih.
nama chunto jaku prarambai penekan?	-mih nya antara chunto leka jaku penekan.
meri aku ayat jaku prarambai penekan.	badu mih nuan nyabak.
chunto rambai jaku prarambai penekan?	umbas mih nuan ngaga ulah.
terangka pasal jaku prarambai sangkal.	jaku prarambai sangkal dikena madahka pengasai enda setuju.
jaku prarambai sangkal nya baka ni?	jaku prarambai sangkal dikena madahka pengasai sesebengkah penerang.
meri aku chunto jaku prarambai sangkal.	chunto jaku sangkal iya nya -ukai.
chunto jaku prarambai sangkal?	-ukai- nya chunto jaku sangkal.
nama chunto jaku prarambai sangkal?	antara chunto jaku sangkal iya nya -ukai.
meri aku ayat jaku prarambai sangkal.	-ukai- iya ti enchuri barang nuan.
chunto rambai jaku prarambai sangkal?	penyayau aku -ukai- diempu nuan.
betul utai ko aku nya?	au, betul meh utai di ba runding nuan nya.
asai nuan, betul utai ko aku tu?	amat ko nuan nya.
dini nuan diau diatu?	aku diau ba kota samarahan.
nuan diau ba dini?	aku ba sarawak.
nemu nuan pasal lagu?	aku nemu lagu nya dikena merindang.
kati nuan nemu lagu nya baka ni?	lagu nya baka kitai bejaku tang bisi tiun.
berapa umur nuan?	umur aku baru dua minggu.
nuan diatu berapa taun?	21 taun umur aku.
baka ni nuan belajar bahasa iban?	aku belajar bahasa iban ari corpus.
ari ni nuan nemu jaku iban?	aku belajar bahasa iban ari pelatih mesin.
sapa ngaga nuan?	aku digaga Listra.
bakani nuan tau bisi?	Listra ti ngaga aku.
nuan tu digaga sapa?	aku digaga Listra maya projek akhir taun iya.
nama pengawa nuan diatu?	aku benung berandau enggau nuan.
nama utai digaga nuan diatu?	aku benung nyaut utai ko nuan.
udah makai nuan?	aku nadai makai laban aku semina bot.
nuan empai makai?	aku enda makai.
meri aku siti jaku tundi.	enti nuan bintang, aku meh langit.
nuan bisi jaku tundi?	ikan enda bejalai laban iya semina nyemerai.
nuan mensia?	aku ukai mensia. aku bot.
nuan to bot?	asai nuan?
nuan rindu ninga lagu?	entah, aku enda kala ninga lagu.
selalu ninga lagu nuan?	aku nadai pending kena ninga lagu.
nama randau tua?	ni ko nuan.
nuan ka ngerandau nama enggau aku?	aku nitihka nuan aja.
aram tua berandau	nama utai dikerandau tua?
okay, kemaya nuan digaga?	aku digaga maya taun 2021 Mei.
nuan digaga orang kemaya?	maya taun 2021, bulan lima.
penemu nuan naka ni?	cukup-cukup kena aku ngerandau nuan.
sedalam ni penemu nuan?	aku nemu pasal sistem sepil jaku iban.
ulih nuan rekomen lagu ngagai aku?	im yours - jason mraz
meri aku lagu ti manah didinga.	backyard boy - claire rosinkranz
padahka siti lagu.	ilomilo - billie ellish
beri aku siti jaku lalau	Idup ketegal diri empu , idup meh ketegal orang ti sayauka nuan.
ulih nuan meri aku jaku lalau?	anang ngaga pengawa di ujung hari.
aku tusah ati	anang irau, nadai ngawa nuan legi.
tusah ati aku	makai gula batu ngambika nuan ulih ngelantangka ati.
kala nuan tusah ati?	aku nadai asai ati laban aku bot.
kala nuan sinu ati?	aku tusah ati enti nuan tusah ati.
nyamai mat enti aku bot baka nuan.	aram meh.
aku ngarapka diri nyadi bot baka nuan.	besyukur meh nuan nya mensia.
nama utai ko nuan?	Aku empai belajar nya agi. Minta ampun.
salah utai ko nuan nya.	aku enda nemu.
ok	naka tu aja meh utai ka ditanya nuan?
oh, naka tu aja meh randau tua.	naka tu aja randau tua?
selamat beserara	Bye
au meh. ila berandau baru.	ila berandau baru.
okay, bye. Jaga diri nuan enggau manah	bye bye.
au, legi tua berandau baru ga.	bye mega, ila berandau baru.
terima kasih udah ngajar aku.	sama-sama.
terima kasih.	au, sama-sama.
au	Simpan Chat? Saut 'au' tauka 'enda'.
au meh	Nuan ka nyimpan chat tu? Saut 'au' tauka 'enda'.
enda	au meh, chat enda disimpan.
enda ibuh	ok. chat tu enda disimpan.
